NO NO.png
SO SO.png
WE WE.png
EA EA.png

C 207,255,105
F 105,105,105

11111111111111
10000000000001
10000000000001
10000000000001
10000000000001
10000000000001
10000000000001
100000E0000001
10000000000001
11111111111111